XXXXX
XCPCX
X   X
X   X
X X X
X F X
XXXXX
