XXXXXXX
XP    X
X  X  X
XX XX X
X  XCCXXXX
XCXXXCCC X
X  XXXXXCX
XXKXCCCCCX
sXDXCCCCCX
sXFXXXXXXX
SXXX
