ssssssssssXXX
XXXXXXXXXXXKX
XCCCCCCCCCCCX
X XXXXXXXXX X
X XCCCCCCCX X
X X XXXXX X X
X X XDDDX X X
X X X XFX X X
X X X XXX X X
X X XCCCCCX X
X X XXXXXXX X
X XCCCCCCCCCX
X XXXXXXXXXXX
XCCCCCPX
XXXXXXXX
