ssX
sXKXssXXsssssXX
sX X XCCXsssXCCX
sX XXX  CXXXC  X
XC    P   D   FX
sX XXX  CXXXC  X
sX XsXCCXsssXCCX
sXCXssXXsssssXX
ssX
