sssssssssXXX
sssssssssXCX
sXXXXXXXXXCX
XF         X
sXXXXXXXXX X
XPXCXCXCX  X
X X X X X  X
X          X
XXXXXXXXXXXX
