sssssssss
sssssssssXX
XXXXXXXXXKX
XP        X
XXXXXXXCCX
X        X
XCCXXXXXXX
X      C X
XXXXXXXXCX
X      C X
XXXXDDXXXX
XFCCCCCCCX
XXXXXXXXXX
