XXXXXXXX
XP    CX
XXX XXXX
XFX X
XDX XXXX
X     KX
XXXXXXXX
