ssssssssXXX
sssssssXF X
ssssssXCX X
XXXXXXXC  X
X D    C  X
X XXXXXXXX
X         X
sX        X
sX        X
sXXXXXCXCX
sXPX XCX X
sX X XCX X
sX X XCX X
sX X XCX X
sX X XCX X
XC CXXCX X
sX XC CX X
sX XCX X X
sX XCXKX X
sX XXXXX X
sX       X
sXXXXXXXXX
