XXXXXXXXXXXXXXXXXX
X       CCZ  XXXPX
X XXX XXXXX  XCX  X
X        CZ  X X  X
XXXXXXXXXXX   Z   CX
X        ZZ   C  XX
XXXXXXXXXXX   C   X
ssssssssXXXXXXXXXZX
ssssssssssssssssX X
ssssssssssXXXXXXX X
ssssssssssXF      X
ssssssssssXXXXXXX X
ssssssssssssssssXXX
