XXXXXXXXXXXXXXX
X   *  M  CCCCX
X  X*  *XXXXXXX
X  XM  *      X
XM*XX  *X X   X
X  XC  *X X C X
XFFXC  *XPX   X
XXXXXXXXXXXXXXX
