XXXXXXXXXXXXXXXXXXXXXXX
XF    CCCCCCCCCCC    FX
X     CM********C     X
X     C*CCCCCCC*C     X
X     C*C  P  C*C     X
X     C*CCCCCCC*C     X
X     C*********C     X
XF    CCCCCCCCCCC    FX
XXXXXXXXXXXXXXXXXXXXXXX
