XXXXXXXXXXXX
XKPCCCCC   X
XXXXXXXX   X
sssssssX   X
XXXXXXXX   X
X          X
XDXXXXXXXXXX
X        C X
XXXXXXXXXX X
sssssssssX X
sssssssssX XXXXXX
sssssssssX     FX
sssssssssXXXXXXXX
